Nutrition Bars	nutrition bars
Protein	protein
Post-Workout & Recovery	post-workout recovery
Amino Acids	amino acids
Weight Gainers	weight gainers
Endurance & Energy	endurance energy
Healthy Snacks & Beverages	healthy snacks beverages
Stationery	stationery
Gift Wrapping Supplies	gift wrapping supplies
Party Supplies	party supplies
Personal Care	personal care
Health Care	health care
First Aid	first aid
Massage & Relaxation	massage relaxation
Cough & Cold	cough cold
Thermometers	thermometers
Stimulants	stimulants
Therapeutic Skin Care	therapeutic skin care
Foot Care	foot care
Smoking Cessation	smoking cessation
Sleep & Snoring	sleep snoring
Allergy, Sinus & Asthma	allergy, sinus asthma
Alternative Medicine	alternative medicine
Stress Reduction	stress reduction
Cold Sore & Fever Blister Treatments	cold sore fever blister treatments
Eye Care	eye care
Feminine Care	feminine care
Ear Care	ear care
Body Art	body art
Lip Care	lip care
Oral Hygiene	oral hygiene
Foot Care	foot care
Shaving & Hair Removal	shaving hair removal
Weight Loss	weight loss
Vitamins	vitamins
Supplements	supplements
Minerals	minerals
Home Tests	home tests
Mobility Aids & Equipment	mobility aids equipment
Respiratory Aids & Accessories	respiratory aids accessories
Daily Living Aids	daily living aids
Bathroom Safety, Aids & Accessories	bathroom safety, aids accessories
Occupational & Physical Therapy Aids	occupational physical therapy aids
Bedroom Aids & Accessories	bedroom aids accessories
Diabetes Care	diabetes care
Cleaning Tools	cleaning tools
Household Batteries	household batteries
Laundry	laundry
Household Cleaning	household cleaning
Paper & Plastic	paper plastic
Mirrors	mirrors
Hair Coloring Tools	hair coloring tools
Nail Tools	nail tools
Makeup Brushes & Tools	makeup brushes tools
Bags & Cases	bags cases
Nails	nails
Makeup Sets	makeup sets
Body	body
Lips	lips
Eyes	eyes
Face	face
Makeup Palettes	makeup palettes
Sets	sets
Bath	bath
Bathing Accessories	bathing accessories
Scrubs & Body Treatments	scrubs body treatments
Eyes	eyes
Face	face
Body	body
Hands & Nails	hands nails
Sets & Kits	sets kits
Sun	sun
Hair Color	hair color
Hair Loss Products	hair loss products
Shampoo Plus Conditioner	shampoo plus conditioner
Hair & Scalp Treatments	hair scalp treatments
Styling Tools	styling tools
Shampoos	shampoos
Shampoo & Conditioner Sets	shampoo conditioner sets
Conditioners	conditioners
Styling Products	styling products
Decorative Pillows, Inserts & Covers	decorative pillows, inserts covers
Kids' Bedding	kids' bedding
Feather Beds	feather beds
Blankets & Throws	blankets throws
Bedspreads & Coverlets	bedspreads coverlets
Shams, Bed Skirts & Bed Frame Draperies	shams, bed skirts bed frame draperies
Bedding Accessories	bedding accessories
Bedding Collections	bedding collections
Feather Bed Covers	feather bed covers
Bed Pillows	bed pillows
Laundry Storage & Organization	laundry storage organization
Home Storage Hooks	home storage hooks
Clothing & Closet Storage	clothing closet storage
Baskets & Bins	baskets bins
Racks, Shelves & Drawers	racks, shelves drawers
Bathroom Storage & Organization	bathroom storage organization
Food Service Equipment & Supplies	food service equipment supplies
Water Coolers & Filters	water coolers filters
Kitchen Utensils & Gadgets	kitchen utensils gadgets
Small Appliances	small appliances
Dining & Entertaining	dining entertaining
Kitchen & Table Linens	kitchen table linens
Storage & Organization	storage organization
Wine Accessories	wine accessories
Small Appliance Parts & Accessories	small appliance parts accessories
Home Brewing & Wine Making	home brewing wine making
Air Conditioners & Accessories	air conditioners accessories
Space Heaters & Accessories	space heaters accessories
Household Fans	household fans
Home Office Furniture	home office furniture
Kitchen & Dining Room Furniture	kitchen dining room furniture
Bedroom Furniture	bedroom furniture
Replacement Parts	replacement parts
Bathroom Furniture	bathroom furniture
Home Entertainment Furniture	home entertainment furniture
Other Furniture	other furniture
Home Bar Furniture	home bar furniture
Living Room Furniture	living room furniture
Kids' Furniture	kids' furniture
Carpet Cleaner Accessories	carpet cleaner accessories
Vacuum Accessories	vacuum accessories
Steam Cleaners & Accessories	steam cleaners accessories
Carpet Cleaners	carpet cleaners
Vacuums	vacuums
Irons	irons
Ironing Boards	ironing boards
Ironing Board Covers	ironing board covers
Garment Steamer Accessories	garment steamer accessories
Ironing Accessories	ironing accessories
Garment Steamers	garment steamers
Towels	towels
Bathroom Accessories	bathroom accessories
Bath Rugs	bath rugs
Pegged Puzzles	pegged puzzles
Puzzle Accessories	puzzle accessories
Floor Puzzles	floor puzzles
Dice & Gaming Dice	dice gaming dice
Game Room Games	game room games
Trading Card Games	trading card games
Game Accessories	game accessories
Game Collections	game collections
Tile Games	tile games
Board Games	board games
Battling Tops	battling tops
Card Games	card games
Stacking Games	stacking games
Standard Playing Card Decks	standard playing card decks
Floor Games	floor games
Travel Games	travel games
Play Vehicles	play vehicles
Play Trains & Railway Sets	play trains railway sets
Die-Cast Vehicles	die-cast vehicles
Pull Back Vehicles	pull back vehicles
Electronics	electronics
Solar	solar
Basic & Life Skills Toys	basic life skills toys
Early Development Toys	early development toys
Science	science
Flash Cards	flash cards
Habitats	habitats
Geography	geography
Musical Instruments	musical instruments
Mathematics & Counting	mathematics counting
Reading & Writing	reading writing
Teddy Bears	teddy bears
Animals & Figures	animals figures
Puppets	puppets
Plush Pillows	plush pillows
Plush Backpacks & Purses	plush backpacks purses
Plush Puppets	plush puppets
Drawing & Painting Supplies	drawing painting supplies
Easels	easels
Clay & Dough	clay dough
Beads	beads
Printing & Stamping	printing stamping
Glue, Paste & Tape	glue, paste tape
Drawing & Sketching Tablets	drawing sketching tablets
Craft Kits	craft kits
Beauty & Fashion	beauty fashion
Pretend Play	pretend play
Gardening Tools	gardening tools
Sports	sports
Pools & Water Fun	pools water fun
Bubbles	bubbles
Marble Games	marble games
Play Tents & Tunnels	play tents tunnels
Sand & Water Tables	sand water tables
Play Sets & Playground Equipment	play sets playground equipment
Ball Pits & Accessories	ball pits accessories
Playhouses	playhouses
Gag Toys & Practical Jokes	gag toys practical jokes
Novelty Games	novelty games
Flying Toys	flying toys
Nesting Dolls	nesting dolls
Miniatures	miniatures
Magnets & Magnetic Toys	magnets magnetic toys
Spy Gadgets	spy gadgets
Wind-up Toys	wind-up toys
Light-Up Toys	light-up toys
Toy Balls	toy balls
Magic Kits & Accessories	magic kits accessories
Puzzles	puzzles
Action & Toy Figures	action toy figures
Games	games
Novelty & Gag Toys	novelty gag toys
Models & Model Kits	models model kits
Coin Collecting	coin collecting
Rockets	rockets
Slot Cars, Race Tracks & Accessories	slot cars, race tracks accessories
Hobby Building Tools & Hardware	hobby building tools hardware
Balloons	balloons
Cake Supplies	cake supplies
Party Favors	party favors
Party Hats	party hats
Party Games & Crafts	party games crafts
Noisemakers	noisemakers
Party Packs	party packs
Building Sets	building sets
Gear Sets	gear sets
Stacking Blocks	stacking blocks
Marble Runs	marble runs
Electronic Pets	electronic pets
Systems & Accessories	systems accessories
Electronic Toys	electronic toys
Personal Video Players & Accessories	personal video players accessories
Plug & Play Video Games	plug play video games
Accessories	accessories
Action Figures	action figures
Doll Accessories	doll accessories
Dolls	dolls
Condiments, Pickles & Relishes	condiments, pickles relishes
Herbs, Spices & Seasonings	herbs, spices seasonings
Packaged Meals & Side Dishes	packaged meals side dishes
Jams, Jellies & Sweet Spreads	jams, jellies sweet spreads
Canned & Jarred Food	canned jarred food
Coffee	coffee
Powdered Drink Mixes	powdered drink mixes
Tea	tea
Juices	juices
Meal Replacement Drinks	meal replacement drinks
Energy Drinks	energy drinks
Hot Cocoa	hot cocoa
Soda Syrups	soda syrups
Fruit Leather	fruit leather
Crackers	crackers
Fruit Snacks	fruit snacks
Baby Formula	baby formula
Beverages	beverages
Fruit	fruit
Cooking Oils, Vinegars & Sprays	cooking oils, vinegars sprays
Sugar Substitutes	sugar substitutes
Flours & Meals	flours meals
Frosting, Icing & Decorations	frosting, icing decorations
Nuts & Seeds	nuts seeds
Cereals	cereals
Breakfast & Cereal Bars	breakfast cereal bars
Chewing Gum	chewing gum
Assortments	assortments
Caramels	caramels
